{
    "name": "pibt_room-64-64-8",
    "weight": false,
    "n_row": 64,
    "n_col": 64,
    "n_endpoint": 0,
    "n_agent_loc": 0,
    "maxtime": 2000,
    "layout": [
        "@@@.@@@@@@@@@@@@@@@.@@@@@@.@@@@@@@.@@@@@@@@@@@@@@.@@@@@@@.@@@@@@",
        "@.......@.......@.......@.......@.......@.......@.......@.......",
        "@.......@.......@.......@.......@.......@.......@.......@.......",
        "........@.......@.......@.......@.......@.......@.......@.......",
        "@.......@.......@.......@.......@.......@.......@.......@.......",
        "@.......................@.......@.......@.......@...............",
        "@.......@.......@.......@.......@.......@.......@.......@.......",
        "@.......@.......@.......................@...............@.......",
        "@.@@@@@@@@@@@.@@@@@@@.@@@.@@@@@@@.@@@@@@@@@@@@@.@@@@@@.@@.@@@@@@",
        "@.......@.......@.......@.......@.......@.......@.......@.......",
        "@.......@.......@.......................@.......@.......@.......",
        "@.......@.......@.......@.......@.......@.......@.......@.......",
        "................@.......@.......@.......@...............@.......",
        "@.......@.......@.......@.......@...............@.......@.......",
        "@.......@.......@.......@.......@.......@.......@...............",
        "@.......@.......@.......@.......@.......@.......@.......@.......",
        "@@@@@@@.@@@@@.@@@@@@@@@@@@@@@@.@@@@@@@@@@@@@@.@@@@@@@@@.@@@@@@.@",
        "@.......@.......@.......@.......@.......@.......@.......@.......",
        "@.......@.......@.......@.......@...............@.......@.......",
        "@.......@.......@.......@.......@.......@.......@.......@.......",
        "........@.......@...............@.......@...............@.......",
        "@.......@.......@.......@.......@.......@.......@.......@.......",
        "@...............@.......@.......@.......@.......@.......@.......",
        "@.......@.......@.......@.......@.......@.......@.......@.......",
        "@.@@@@@@@@.@@@@@@@@@@.@@@@@@@@.@@@@@@@.@@.@@@@@@@.@@@@@@@@@@@@@.",
        "@...............@.......@.......@.......@.......@.......@.......",
        "@.......@.......@.......@.......@.......@.......@.......@.......",
        "@.......@.......@.......@...............@.......@.......@.......",
        "@.......@.......@.......@.......@.......@.......@.......@.......",
        "........@.......@.......@.......@.......@.......@.......@.......",
        "@.......@.......@.......@.......@.......@.......@...............",
        "@.......@.......@...............@.......@.......@.......@.......",
        "@@@@@@@@@@@@@@@@@@.@@@@@@@@.@@@@@@@@@@@@@@@@@@@@@@@@@@@.@@.@@@@@",
        "@.......@.......@.......@.......@.......@.......@.......@.......",
        "@.......@.......@.......@...............@.......@.......@.......",
        "@.......@.......@.......@.......@.......@.......@.......@.......",
        "@...............@...............@.......@.......@.......@.......",
        "@.......@.......@.......@.......@.......@.......@...............",
        "........@.......@.......@.......@...............@.......@.......",
        "@.......@.......@.......@.......@.......@.......@.......@.......",
        "@@@@@@@.@@@@@@@@@@@@@@@@@@@.@@@@@@.@@@@@@@@@@@.@@@@@.@@@@@@@.@@@",
        "@.......@.......@.......@.......@.......@...............@.......",
        "@.......@.......@.......................@.......@.......@.......",
        "@.......@...............@.......@.......@.......@.......@.......",
        "@.......@.......@.......@.......@.......@.......@.......@.......",
        "@.......@.......@.......@.......@.......@.......@.......@.......",
        "@...............@.......@.......@.......@.......@.......@.......",
        "........@.......@.......@.......@.......@.......@.......@.......",
        "@@@@.@@@@.@@@@@@@@.@@@@@@@@@@@.@@@@@@@@@@@@@@@.@@@@@@@@@@@@@@@@@",
        "........@.......@.......@.......@.......@.......@.......@.......",
        "@.......@.......@.......@.......@.......@.......@.......@.......",
        "@.......@.......@.......@.......@.......@.......@.......@.......",
        "@.......@.......@.......@.......@.......@.......@...............",
        "@.......@.......@.......@.......@.......@.......@.......@.......",
        "@.......@.......@.......@.......@.......@.......@.......@.......",
        "@.......@.......................................@.......@.......",
        "@@@@@@@@@@@.@@@@@@@@@@@@@@@@@@@.@@@@@@@@@@@@@.@@@@@@@@@.@@@@@@@@",
        "@.......@.......@.......@.......@.......@.......@.......@.......",
        "@.......................@.......@.......@.......@.......@.......",
        "@.......@.......@...............@.......@.......................",
        "@.......@.......@.......@.......@.......@.......@.......@.......",
        "@.......@.......@.......@.......@.......@.......@.......@.......",
        "........@.......@.......@.......@.......@.......@.......@.......",
        "@.......@.......@.......@.......@...............@.......@......."
    ]
}