{
    "name": "pibt_random_unweight_48x48",
    "layout": [
        "..@@@...@.@..@@....@......@...@.@..@............",
        "........@...@@.@....@..@...@.....@.......@......",
        "....@....@.....@.......@....@........@..@@@..@..",
        "...@....@@..@.@.....@..@....@............@......",
        "....@...@....@......@..@...........@.@@....@.@..",
        "....@...@.........@@...@.......@...@.@...@@...@@",
        "........@..@....@@.@......@..@@@@.....@....@....",
        ".@.@..@@........@....@......@@......@@....@..@..",
        "..@.......@......@@...........@@@.......@.......",
        "@....@..@..@.@.............@..@.......@...@@@...",
        "...........@..@................@....@..@.@......",
        ".....@.@@............@.@.@@.@..@...........@....",
        "..@......@....@....@..@......@..............@@..",
        "......@..@.............@...@..............@.@...",
        "..@........@@....@.......@..@@......@...........",
        ".....@..@@@.......@............@@.............@@",
        "..@@@...@........@@..@.@...@......@........@@.@.",
        "@@........@...@.....@@....@@......@@............",
        ".....@@..............@@@......@...@.@......@....",
        "..@@...@.@.....@.....@@..@@..@...@...@...@..@...",
        "@.................@...@..@.@.@......@..@@......@",
        "...@...@......@@.........@...@........@...@....@",
        ".......@@@....@.............@@@.@......@@.......",
        "..@..@........@......@............@.....@.@@..@.",
        "..@................................@..@.@..@@...",
        "..........@..@.@@.@.....@.................@....@",
        ".@...@@....@....@........@.......@.@......@@....",
        ".....@....@@.....@.@.@..@...........@....@..@...",
        ".........@.........@.......................@@..@",
        "........@........@..........@....@........@...@@",
        ".....@............@........@...............@..@@",
        "...@.@....@@@...@..@...........@.....@....@@....",
        "...@........@..@.@....@@.......@......@..@..@...",
        "@.......@......@............@@.@.....@........@@",
        "@..@...@....................@@.@.@....@...@.@...",
        "..@........@...@......@.@........@.@...@........",
        "........@.........@..@...@@........@......@...@.",
        "@...@.@....@......@@........@..@@@............@.",
        "@@..@....@@....@@@@......@...@......@@.@.@......",
        "...@.@............@............@@.@.@.........@.",
        "..........@...@@......@.@...@.........@..@...@@@",
        ".........@.@.....@...@..@........@.....@@.....@.",
        ".@@...@......@.@...@....@.@..@..@......@........",
        "....@.......@@...@@.@@.@.......@......@......@.@",
        ".....@.@......@@.@........@......@..............",
        "......@...............@.@..@@@.....@..@...@@....",
        ".......@....@...@...@...@....@.@..@.......@.....",
        "..@..@....@.@...@@..@......@..@........@..@@...@"
    ],
    "milp_runtime": null,
    "optimize_wait": false,
    "weight": false,
    "n_row": 48,
    "n_col": 48
}