{
    "name": "pibt_maze-32-32-4",
    "layout": [
        "@@@@@@@@@@@@@@@@@@@@@@@@@@@@@@@@",
        "@...................@....@......",
        "@...................@....@......",
        "@...................@....@......",
        "@...................@....@......",
        "@....@@@@@@....@@@@@@....@@@@@@.",
        "@.........@.....................",
        "@.........@.....................",
        "@.........@.....................",
        "@.........@.....................",
        "@@@@@@@@@@@@@@@@....@....@@@@@@@",
        "@...................@....@......",
        "@...................@....@......",
        "@...................@....@......",
        "@...................@....@......",
        "@....@@@@@@@@@@@@@@@@@@@@@....@.",
        "@.............................@.",
        "@.............................@.",
        "@.............................@.",
        "@.............................@.",
        "@....@@@@@@@@@@@@@@@@....@@@@@@@",
        "@.........@....@.........@......",
        "@.........@....@.........@......",
        "@.........@....@.........@......",
        "@.........@....@.........@......",
        "@....@....@....@@@@@@@@@@@@@@@@.",
        "@....@....@.....................",
        "@....@....@.....................",
        "@....@....@.....................",
        "@....@....@.....................",
        "@@@@@@....@@@@@@@@@@@@@@@@....@.",
        "@.............................@."
    ],
    "milp_runtime": null,
    "optimize_wait": false,
    "weight": false,
    "n_row": 32,
    "n_col": 32,
    "n_endpoint": 0,
    "n_agent_loc": 0,
    "maxtime": 1000
}