{
    "name": "pibt_random-64-64-20",
    "weight": false,
    "n_row": 64,
    "n_col": 64,
    "n_endpoint": 0,
    "n_agent_loc": 0,
    "maxtime": 2000,
    "layout": [
        "......@..@...@@@.@..@....@..@....@...............@..........@@..",
        "..@.....@@..@.................@.........@...@...@.@.@.@.........",
        "...@.@........@..........@@..@.....@@......@...@...@............",
        "...............@@....@.@...@............@...@.....@.....@@@....@",
        "..@....@..@................@.......@@@......@........@.......@@@",
        ".....@@..@.@....@.............@.@...@......@.....@@.@...........",
        "..@......@....@..@.@.@...@@...@....@...........@@@..@..@..@....@",
        "...@@@.@.....@.@....@...@@...@...............@.@....@....@.....@",
        "@@.@...@.....@.....@.....@.............@@@..@...@......@........",
        "..........@...@@........@...@...@....@.........@.........@......",
        "....@.......@..@..............@.........................@...@@..",
        "........@.@@..@............@@.@@@...@....@..@..@.@@.@..@@.@..@.@",
        ".@..@@@...........@..............@...@..........@@@@......@..@..",
        ".@....@...@.....@@.....@....@...@....@.........@..@@@.....@@...@",
        ".......@...........@...@...........@@...........................",
        ".......@@....@....@..@..@..@@.....@.@.......@......@..@@@@....@.",
        ".......@.........@.@..@.@........@............@........@...@....",
        "...@.............@.............@....@.@......@...@.............@",
        "..............@@..@@......@..@..................@....@..@....@..",
        "@.@....@..@..@.@..@.@@.....................@@...............@@..",
        ".@.......@..........@.@@........@..@@.....@T@......@.....@......",
        "...@..@...@..@...@..@.....@..............@.@.@....@..@....@.....",
        "........@@............@.....@........@@.........................",
        "..@....@..............@...................@.....@.....@@........",
        "....@.@.......@..@.@...........@.......................@.....@@.",
        ".@.....@@...........@@.@.@.@.@.@@...@..@.@.......@@.........@...",
        "...@...@.@@....@.........@@...@.....@...................@..@@...",
        "@.@@.@....@.......@.............@..@....@...............@.......",
        ".....@................@@....@.@.......@@........@..@....@.....@.",
        "..@@......@.@.@.....@...@@..@.@.....@......................@...@",
        "@@....@...@................@.............@.......@...@...@..@..@",
        "...................@.@.........@@.....@.....@.....@....@.....@..",
        "@.@@....@.@..@.@..@..@..........@......@.@..@..@...@..@.........",
        "@.....@................@.@.@.....@@.@...@..@.....@..@...........",
        ".............@..@@...@..@...@@@@.....@..@.......@...@....@@....@",
        "@.@.......@...@..@...........@..@.........@....@..@..@.@........",
        "T@@@..@..@...............@......@..........@...@...@.@..@..@@..@",
        "T@....@...............@.....@..@..@@......@@...............@@...",
        "@......@.@@.@..@@.@@@...@.......@......@.........@....@....@....",
        ".........@@@........@@...........@.....@....@.@.@....@.@...@....",
        "................@.@..@@.....@...@.@.@..@........@...@..........@",
        "...@..@..@.........@@.....@....@.........@..@...@@@...........@T",
        "..@.....@...@............@..@......@....@......@.....@@@....@.@T",
        "........@.....@@....@.....@.@.....@.....@.@..@..............@..@",
        "...@.........@....@................@.@@...........@.....@...@...",
        "..@@@......@@..........@@.................@..@...@@..@.......@..",
        "@..@........@..@.@...@....@.......@......@...@...........@......",
        ".....@.@.......@.@@......@.....@..@...@......@@@.....@.......@@.",
        "..@....@...@@....@.@.@@@........@...@.@.......@.....@.....@.....",
        ".............@@.....@@...@.......@@.@....@.@.....@@.@@.......@..",
        "..@.......@......@......@...........@@.@..........@.@@..@..@....",
        ".....@....@@..@...@...@.......@......@....@..@@....@...@.@......",
        "..@.......@..@.............@.@@......@@.@...@.........@........@",
        "@@...@....@.@..@.@..@..@..@.@.@...@@@...@.@......@..@....@....@.",
        ".....@.......@.......@..@..........@T@............@.....@.@.@...",
        "...@....@......@.@...@..@..@.....@@@T@...@.....@..@.@..@...@....",
        ".....@.....@...@...@@...@...@@..@...@..............@...@...@.@@.",
        ".......@....@.@@...@@.@@........@....@.@.@@@..@....@....@@..@...",
        "......@....@@....@@.@.@....@.@.@..@.@......@...@.....@@.........",
        ".......@@..@...........@....@....@......@..@..@...@.@.@@@......@",
        ".@.........@....@..@.....@.........@@..@.....@.....@...@..@.....",
        "@.@...@...@...@...@@@@@.@..@@....................@.@@...@....@..",
        "@..........@@.....@..@...@........@@.@.@....@..@@...............",
        "@.@....@...............@........@..@.@@@.............@@.@......."
    ]
}